"ag" = (/obj/effect/turf_decal/siding/wood{dir = 10},/obj/machinery/microwave,/obj/structure/table/reinforced,/turf/open/floor/iron/kitchen,/area/hilbertshotel)
"aj" = (/obj/structure/mineral_door/wood,/turf/open/floor/wood,/area/hilbertshotel)
"au" = (/obj/effect/turf_decal/siding/wood{dir = 10},/obj/structure/table,/obj/item/flashlight/lamp,/turf/open/floor/carpet/royalblue,/area/hilbertshotel)
"aI" = (/obj/effect/turf_decal/siding/wood{dir = 5},/obj/machinery/door/window/eastleft,/turf/open/floor/iron/kitchen,/area/hilbertshotel)
"bo" = (/obj/machinery/vending/dinnerware{contraband = list(/obj/item/kitchen/rollingpin=2,/obj/item/kitchen/knife/butcher=2,/obj/item/reagent_containers/food/condiment/flour=4); shut_up = 1},/turf/closed/indestructible/wood,/area/hilbertshotel)
"bN" = (/obj/machinery/light{color = "FFB43A"},/turf/open/floor/wood/wood_tiled,/area/hilbertshotel)
"cs" = (/obj/machinery/computer{dir = 4},/obj/item/choice_beacon/box/plushie,/obj/effect/turf_decal/siding/wood{dir = 9},/turf/open/floor/carpet/royalblue,/area/hilbertshotel)
"ct" = (/obj/effect/turf_decal/siding/wood{dir = 6},/obj/structure/closet/cabinet{anchored = 1},/obj/item/clothing/suit/hooded/wintercoat,/obj/item/clothing/shoes/winterboots{pixel_x = 2; pixel_y = -2},/turf/open/floor/carpet/red,/area/hilbertshotel)
"cB" = (/obj/structure/chair/pew/left,/turf/open/floor/wood/wood_tiled,/area/hilbertshotel)
"dL" = (/obj/machinery/light_switch/directional/north,/turf/open/floor/wood/wood_tiled,/area/hilbertshotel)
"dN" = (/obj/machinery/vending/boozeomat,/turf/closed/indestructible/wood,/area/hilbertshotel)
"dV" = (/obj/effect/turf_decal/siding/wood{dir = 1},/obj/structure/chair/sofa/left,/turf/open/floor/carpet/green,/area/hilbertshotel)
"er" = (/obj/effect/turf_decal/siding/wood{dir = 1},/turf/open/floor/iron/kitchen,/area/hilbertshotel)
"fr" = (/obj/effect/turf_decal/siding/wood{dir = 8},/obj/structure/sink/kitchen/directional/east,/obj/machinery/light{dir = 8},/turf/open/floor/iron/kitchen,/area/hilbertshotel)
"gl" = (/obj/structure/chair/pew,/turf/open/floor/plating/asteroid/snow{initial_gas_mix = "o2=21.78;n2=82.36;TEMP=275"},/area/hilbertshotel)
"gA" = (/obj/machinery/light{dir = 1; color = "FFB43A"},/obj/structure/chair/pew,/turf/open/floor/wood/wood_tiled,/area/hilbertshotel)
"gO" = (/obj/structure/closet/crate/wooden,/obj/item/stack/sheet/mineral/wood/fifty,/obj/item/reagent_containers/glass/bucket{pixel_y = 7},/turf/open/floor/wood/wood_tiled,/area/hilbertshotel)
"hg" = (/obj/structure/flora/tree/dead,/turf/closed/indestructible/rock/snow,/area/hilbertshotel)
"hi" = (/obj/effect/turf_decal/siding/wood{dir = 10},/obj/structure/table/wood,/turf/open/floor/carpet/red,/area/hilbertshotel)
"hE" = (/obj/effect/turf_decal/siding/wood{dir = 5},/obj/structure/closet/cabinet{anchored = 1},/obj/item/clothing/suit/hooded/wintercoat,/obj/item/clothing/shoes/winterboots{pixel_x = 2; pixel_y = -2},/turf/open/floor/carpet/red,/area/hilbertshotel)
"kA" = (/obj/structure/chair/pew/left{dir = 4},/turf/open/floor/wood/wood_tiled,/area/hilbertshotel)
"kE" = (/obj/effect/turf_decal/siding/wood{dir = 9},/obj/structure/closet/crate/bin{pixel_x = -6},/turf/open/floor/iron/kitchen,/area/hilbertshotel)
"kV" = (/obj/structure/chair/pew/right,/turf/open/floor/wood/wood_tiled,/area/hilbertshotel)
"ld" = (/obj/effect/turf_decal/siding/wood{dir = 4},/obj/machinery/reagentgrinder,/obj/structure/table/reinforced,/turf/open/floor/iron/kitchen,/area/hilbertshotel)
"mo" = (/obj/effect/turf_decal/siding/wood{dir = 4},/turf/open/floor/carpet/red,/area/hilbertshotel)
"mM" = (/obj/effect/turf_decal/siding/wood{dir = 1},/turf/open/floor/carpet/royalblue,/area/hilbertshotel)
"np" = (/obj/effect/turf_decal/siding/wood{dir = 4},/turf/open/floor/carpet/green,/area/hilbertshotel)
"nt" = (/obj/machinery/light{dir = 4; color = "FFB43A"},/turf/open/floor/wood/wood_tiled,/area/hilbertshotel)
"nu" = (/obj/structure/toilet{dir = 8},/turf/open/indestructible/hoteltile,/area/hilbertshotel)
"ow" = (/obj/structure/streetdecor/lamp,/turf/open/floor/plating/asteroid/snow{initial_gas_mix = "o2=21.78;n2=82.36;TEMP=275"},/area/hilbertshotel)
"oB" = (/obj/machinery/light{dir = 8},/obj/effect/turf_decal/siding/wood{dir = 8},/obj/structure/table/wood,/obj/structure/reagent_dispensers/keg/mead,/turf/open/floor/carpet/red,/area/hilbertshotel)
"pK" = (/obj/effect/turf_decal/siding/wood,/obj/structure/table/wood,/turf/open/floor/carpet/red,/area/hilbertshotel)
"qc" = (/obj/effect/turf_decal/siding/wood{dir = 6},/turf/open/floor/carpet/green,/area/hilbertshotel)
"qm" = (/obj/structure/flora/tree/pine,/turf/open/floor/plating/asteroid/snow{initial_gas_mix = "o2=21.78;n2=82.36;TEMP=275"},/area/hilbertshotel)
"qK" = (/turf/closed/indestructible/rock/snow,/area/hilbertshotel)
"sy" = (/obj/structure/closet/cabinet{anchored = 1},/obj/effect/turf_decal/siding/wood{dir = 6},/turf/open/floor/carpet/royalblue,/area/hilbertshotel)
"tZ" = (/obj/effect/turf_decal/siding/wood,/turf/open/floor/carpet/royalblue,/area/hilbertshotel)
"uM" = (/obj/structure/bookcase/random/adult,/turf/closed/indestructible/wood,/area/hilbertshotel)
"uV" = (/turf/open/floor/plating/ice/smooth{initial_gas_mix = "o2=21.78;n2=82.36;TEMP=275"},/area/hilbertshotel)
"vH" = (/obj/effect/turf_decal/siding/wood{dir = 9},/obj/structure/chair/sofa/corner{dir = 4},/turf/open/floor/carpet/green,/area/hilbertshotel)
"wY" = (/obj/structure/flora/grass/both,/turf/open/floor/plating/asteroid/snow{initial_gas_mix = "o2=21.78;n2=82.36;TEMP=275"},/area/hilbertshotel)
"xg" = (/turf/open/floor/wood/wood_tiled,/area/hilbertshotel)
"xm" = (/obj/structure/sink{dir = 8; pixel_x = -12; pixel_y = 2},/obj/structure/mirror{pixel_x = -32},/turf/open/indestructible/hoteltile,/area/hilbertshotel)
"xn" = (/obj/structure/chair/pew/left,/turf/open/floor/plating/asteroid/snow{initial_gas_mix = "o2=21.78;n2=82.36;TEMP=275"},/area/hilbertshotel)
"xS" = (/obj/structure/reagent_dispensers/watertank,/turf/open/floor/wood/wood_tiled,/area/hilbertshotel)
"yu" = (/turf/open/floor/plating/snowed/smoothed{initial_gas_mix = "o2=21.78;n2=82.36;TEMP=275"},/area/hilbertshotel)
"yH" = (/turf/open/floor/wood/wood_large,/area/hilbertshotel)
"yW" = (/obj/structure/window/reinforced,/obj/structure/curtain/goliath,/obj/structure/table/wood,/obj/item/flashlight/lamp/green,/turf/open/floor/wood/wood_tiled,/area/hilbertshotel)
"zD" = (/obj/structure/chair/sofa/right{dir = 1},/obj/effect/turf_decal/siding/wood,/turf/open/floor/carpet/green,/area/hilbertshotel)
"zL" = (/obj/effect/turf_decal/siding/wood{dir = 1},/obj/machinery/light{dir = 1},/obj/machinery/light_switch/directional/north,/turf/open/floor/carpet/red,/area/hilbertshotel)
"zW" = (/turf/closed/indestructible/hoteldoor{icon_state = "door_closed"; icon = 'icons/obj/doors/puzzledoor/default.dmi'},/area/hilbertshotel)
"Ay" = (/obj/structure/flora/tree/pine,/turf/closed/indestructible/rock/snow,/area/hilbertshotel)
"BK" = (/obj/effect/turf_decal/siding/wood{dir = 8},/obj/structure/chair/sofa/middle{dir = 4},/turf/open/floor/carpet/green,/area/hilbertshotel)
"BM" = (/obj/machinery/light{dir = 4},/obj/machinery/light_switch/directional/east,/turf/open/floor/wood/wood_tiled,/area/hilbertshotel)
"CC" = (/turf/open/floor/plating/asteroid/snow{initial_gas_mix = "o2=21.78;n2=82.36;TEMP=275"},/area/hilbertshotel)
"CY" = (/obj/structure/closet/crate/wooden,/obj/item/lighter/gold,/obj/item/stack/sheet/mineral/wood/fifty,/obj/machinery/light{dir = 4},/turf/open/floor/wood/wood_tiled,/area/hilbertshotel)
"CZ" = (/obj/machinery/light{dir = 1},/turf/open/floor/wood/wood_tiled,/area/hilbertshotel)
"Dk" = (/obj/structure/table/wood,/turf/open/floor/wood/wood_tiled,/area/hilbertshotel)
"Dw" = (/obj/structure/table/wood,/turf/open/floor/wood/wood_large,/area/hilbertshotel)
"DB" = (/obj/structure/table/wood,/obj/structure/bedsheetbin/towel,/turf/open/floor/wood/wood_large,/area/hilbertshotel)
"En" = (/obj/machinery/jukebox{req_one_access = null; one_area_play = 1},/turf/open/floor/wood/wood_tiled,/area/hilbertshotel)
"Gm" = (/obj/structure/chair/pew/right{dir = 4},/turf/open/floor/wood/wood_tiled,/area/hilbertshotel)
"GC" = (/obj/effect/turf_decal/siding/wood{dir = 10},/obj/structure/chair/sofa/corner{dir = 1},/turf/open/floor/carpet/green,/area/hilbertshotel)
"Hv" = (/obj/effect/turf_decal/siding/wood{dir = 6},/obj/effect/spawner/lootdrop/three_course_meal,/obj/effect/spawner/lootdrop/three_course_meal,/obj/structure/table/reinforced,/turf/open/floor/iron/kitchen,/area/hilbertshotel)
"Ig" = (/obj/machinery/light/small{dir = 4},/turf/open/indestructible/hoteltile,/area/hilbertshotel)
"IR" = (/obj/structure/mineral_door/wood,/turf/open/indestructible/hoteltile,/area/hilbertshotel)
"Jq" = (/turf/open/floor/carpet/red,/area/hilbertshotel)
"JG" = (/turf/closed/indestructible/wood,/area/hilbertshotel)
"Kg" = (/obj/structure/closet/cabinet,/turf/open/floor/wood/wood_large,/area/hilbertshotel)
"Kh" = (/obj/effect/turf_decal/siding/wood{dir = 5},/turf/open/floor/carpet/green,/area/hilbertshotel)
"KW" = (/obj/machinery/vending/games{shut_up = 1},/turf/closed/indestructible/wood,/area/hilbertshotel)
"Lc" = (/obj/structure/chair/office/dark{dir = 8},/obj/effect/turf_decal/siding/wood{dir = 1},/turf/open/floor/carpet/royalblue,/area/hilbertshotel)
"Mh" = (/obj/structure/mineral_door/wood,/turf/closed/indestructible/wood,/area/hilbertshotel)
"Na" = (/obj/machinery/light,/turf/open/floor/wood/wood_tiled,/area/hilbertshotel)
"Nj" = (/obj/effect/turf_decal/siding/wood{dir = 9},/obj/structure/table/wood,/obj/structure/reagent_dispensers/beerkeg,/turf/open/floor/carpet/red,/area/hilbertshotel)
"NZ" = (/obj/structure/mineral_door/woodrustic,/obj/structure/fans/tiny/invisible,/turf/open/floor/wood/wood_tiled,/area/hilbertshotel)
"Oh" = (/obj/machinery/vending/coffee{shut_up = 1},/turf/closed/indestructible/wood,/area/hilbertshotel)
"OS" = (/obj/structure/mineral_door/woodrustic,/turf/open/floor/wood/wood_tiled,/area/hilbertshotel)
"Qu" = (/obj/effect/turf_decal/siding/wood{dir = 1},/turf/open/floor/carpet/red,/area/hilbertshotel)
"QE" = (/obj/structure/flora/bush,/turf/open/floor/plating/asteroid/snow{initial_gas_mix = "o2=21.78;n2=82.36;TEMP=275"},/area/hilbertshotel)
"Rn" = (/obj/structure/fireplace{dir = 8},/turf/open/floor/wood/wood_tiled,/area/hilbertshotel)
"Tx" = (/obj/machinery/telecomms/relay/preset/auto,/turf/open/floor/catwalk_floor,/area/hilbertshotel)
"Ua" = (/obj/structure/mineral_door/wood,/turf/open/floor/wood/wood_tiled,/area/hilbertshotel)
"Uq" = (/obj/structure/sauna_oven,/turf/open/floor/wood/wood_tiled,/area/hilbertshotel)
"UY" = (/obj/machinery/light,/obj/effect/turf_decal/siding/wood,/obj/structure/table/wood,/turf/open/floor/carpet/red,/area/hilbertshotel)
"Vd" = (/obj/effect/turf_decal/siding/wood,/obj/item/sharpener,/obj/structure/table/reinforced,/turf/open/floor/iron/kitchen,/area/hilbertshotel)
"Vy" = (/obj/structure/chair/pew/right,/turf/open/floor/plating/asteroid/snow{initial_gas_mix = "o2=21.78;n2=82.36;TEMP=275"},/area/hilbertshotel)
"Wp" = (/obj/machinery/shower{desc = "Despite their age, they seem clean and capable of providing hot water just as well as their modern counterparts. Hopefully Nanotrasen cleaned the water pipes this well..."; dir = 4},/obj/structure/curtain,/obj/item/soap,/turf/open/indestructible/hoteltile,/area/hilbertshotel)
"WR" = (/obj/structure/window/reinforced,/obj/structure/curtain/goliath,/obj/structure/table/wood,/turf/open/floor/wood/wood_tiled,/area/hilbertshotel)
"Xg" = (/obj/structure/bed/double,/obj/item/bedsheet/random/double,/obj/effect/turf_decal/siding/wood{dir = 5},/obj/machinery/light_switch/directional/north,/turf/open/floor/carpet/royalblue,/area/hilbertshotel)
"Xq" = (/turf/open/floor/iron/kitchen,/area/hilbertshotel)
"XS" = (/obj/structure/dresser,/obj/effect/turf_decal/siding/wood{dir = 1},/obj/machinery/light/small{dir = 1},/turf/open/floor/carpet/royalblue,/area/hilbertshotel)
"Yh" = (/obj/structure/showcase/machinery/tv,/turf/open/floor/wood/wood_tiled,/area/hilbertshotel)
"YZ" = (/obj/structure/table/wood/fancy,/turf/open/floor/carpet/green,/area/hilbertshotel)
"ZY" = (/obj/machinery/vending/kink{shut_up = 1},/turf/closed/indestructible/wood,/area/hilbertshotel)

(1,1,1) = {"
JGJGJGJGZYJGJGdNboOhuMuMuMKWJGJG
JGcsLcXSmMXgJGkEeraIxgxgxgxgYhJG
JGautZtZtZsyJGfrXqldxgvHdVKhBMJG
JGJGIRJGMhJGJGagVdHvxgBKYZnpRnJG
JGWpIgJGxgCZdLxgxgxgxgGCzDqcCYJG
JGxmnuJGxgxgxgxgNaxgxgxgNaxgEnJG
JGJGJGJGUaJGJGJGJGyWWRWRJGJGJGJG
JGNjQuzLQuhEJGwYowxnglVyowCCCCAy
JGoBJqJqJqmoajyuyuyuyuyuQEqmuVhg
JGhipKUYpKctJGCCyuQEwYyuCCuVuVqK
JGJGJGJGJGJGJGJGOSJGCCyuwYuVuVAy
JGDkcBgAkVxSJGKgxgJGQEyuCCuVuVhg
JGGmyHyHyHgOJGKgntJGCCyuwYuVuVqK
JGkAyHyHyHxgNZxgxgJGwYyuCCuVuVAy
JGUqxgbNxgxgJGDBDwJGCCyuCCuVqKqK
JGJGJGJGJGJGJGJGJGJGhgzWhgqKAyTx
"}
